anonymous : without a name
another : one more, different
answer : a reply, a solution 
accoutre : to furnish with dress and trappings (esp. a warrior)
acquit : set free, conduct well
adverb : word that modifies a verb
adversary : an enemy
adze : tool for cutting away surface of wood
aegis : shield, protection
aerate : combine with air
affront : an insult
affable : pleasant, easy to speak to
affluence : abundance, wealth
backgammon : a game
bail : one who gives security 
bairn : child
bald : without hair, bare
bale : a package, misery
benevolent : generous, kindly, charitable
benight : overtake by night 
bestead : help, relive, avail
bet : lay a wager
beverage : a drink
bewail : lament
broil : cook in fire
broke : past tense of BREAK
brunt : the force of the blow
buff : thick strong velvety leather, a light yellow colour
card : comb wool etc
career : a profession
carpet : a thick woven covering for the floor, rug
carriage : conveyance, a vehicle for carrying
clamp : a device to hold things together
clan : a tribe
clandestine : concealed, hidden
clergy : the ministers of the Christian religion
clever : skilful
codify : edit, arrange systematically
coeducation : education imparted for both sexes together
cohesion : sticking together
coil : a rope which has been wound or gathered in rings
coerce : compel
collar : neck band
colloquy : a conversation
collude : work together secretly
concession : rebate, favour, act of conceding
conch : a spiral shell
concoct : fabricate, make up, scheme
concomitant : accompanying, resulting
condone : pardon
debacle : sudden collapse
debar : exclude, prevent
debase : make lower in value, degrade
decay : decomposition, declination
decease : death
decide : settle, determine, give, judgement
deck : the upper floor or covering of a ship
desultory : inconstant, hasty, unsettled
detach : separate, unfasten
declamation : set speech in fine language
destiny : fate, decree
destitute : needy, helpless
disable : make unfit, cripple
disaffection : dislike, hostility, disgust
disclaim : disown, give up all claims
discomfort : inconvenience
dryad : wood-nymph
ductile : yielding, flexible, malleable
duke : a sovereign, prince, a noble
duly : properly, at the right time
ebb : decay, flow back
ebony : a kind of hard black wood
eclectic : selecting the best
ecstasy : great joy, mad delight, rapture
edible : eatable
eject : expel, emit
elaborate : to explain fully
empower : give power to 
enclave : region surrounded by foreign country 
endear : to make dear 
encamp : live in camp, rest 
equine : pertaining to a horse, horse-like
erasure : rubber, what has been rubbed out
erode : eat away gradually
eschew : to avoid, to shun
espirit : shrewdness
escort : body-guard on a journey
expatiate : speak or write in detail
expunge : remove
fallible : imperfect, liable to make mistakes
familiarize : accustom, make well known
fanfare : loud blowing of trumpets
fascinate : attract, enchant
flash : give light, come suddenly
flaunt : display, flutter
flay : strip, skin, peel
flimsy : thin, weak, easily, weak
flog : beat with a whip or rod
glutton : one who eats to excess, a great lover of reading books
goblin : demon, an evil spirit
goose : a web-footed swimming bird like the duck
guise : appearance, dress
gullible : capable of being deceived
gunny : a coarse kind of sacking woven form jute
gynarchy : rule by a female
hem : border, margin, edge
henpecked : meekly, submissive to wife
herbivorous : herb-eating
heretic : sectary, dissenter 
hern : a long-legged
horde : a wandering tribe, a multitude
horseplay : touch handling
hound : hunting dog
icicle : hanging piece of ice
iconoclast : a breaker of idols
ideology : system of ideas manner of thinking
ignorance : lack of knowledge, not educated 
imperial : pertaining to an empire or its ruler
impinge : to impel, collide
imposition : act of imposing, that which is imposed
incredulous : refusing to believe
incurious : uninteresting, careless
indelicate : not delicate, immodest
indemnify : to compensate of loss or damage, free responsibility
inquiry : investigation
inquisitive : curious to know
inroad : raid, any illegal encroachment
insidious : cunning, doing harm secretly
insight : knowledge, intuition
insoluble : that cannot be dissolved 
involve : include, entangle
invulnerable : not able to be wounded or hurt
jump : a sudden movement
junction : a meeting place(especially) where lines of railway meet
jurisprudence : the science of law
jurist : one learned in law
jute : the coarse fibre of an Indian plant
juvenile : youthful
lambative : a medicine to be licked
lambent : flickering
lancet : double-edged surgical knife
landgravine : a German Countess
landholder : owner of a land
larynx : the organ of voice
lascar : an Indian sailor
lassitude : tiredness
litigation : a law suit, contention
litre : a liquid measure equivalent to 1000 CC.
lodestone : a magnetic ore of iron
loaf : mass of bread
lobby : talk to win favour
maiden : pure, unused, first
mail : armour post
malign : slander, abuse
misconstrue : misjudge, give a wrong meaning
myopia : short sight
myriad : very great number, thousand
myth : traditional story, religious legend
nominee : one nominated
nonage : minority
offal : refuse, waste
offence : illegal act, insult, crime
outhouse : a small building near the residence
outing : a pleasure trip
outspoken : candid, frank
papyrus : a seed once used to make paper
parcel : divide, pack up in to parcels
parish : a district under the care of a parson
pluck : spirit, courage
plumage : bird, feathers
pod : seed-case of leguminous plants, cocoons of silkworms
proclivity : a tendency, leaning towards something, inclination
recite : narrate, to repeat from memory
reck : to care for
slovenly : negligent, untidy, disorderly
slush : partly melted snow, soft mud
spasmodic : occurring irregularly
spite : tease, annoy, show ill-feeling towards
staunch : loyal, steadfast
student : a person who studies something
suavity : agreeableness, pleasantness
talisman : something, considered to bring luck, charm
taper : make smaller towards and end
tomboy : a girl who plays boy's games
torchbearer : one who carries a torch, a leader
trowel : a flat-bladed implement
tuck : gather up or roll
untoward : crass, awkward, vexatious
upright : honest, erect
wager : that which is waged or pledged, a bet
wallaby : a small kangaroo
wane : decline, decrease
wilful : obstinate, fond of having one's own way
winsome : agreeable, attractive, engaging
zealous : ardent, enthusiastic
zymotic : relating to or produced by fermentation
